NO ./pics/purplestone_NO.xpm
SO ./pics/purplestone_SO.xpm
WE ./pics/purplestone_WE.xpm
EA ./pics/purplestone_EA.xpm

F 0,60,0
C 25,25,112

        1111111111111111111111111
    11111000000000110000000000001
    10111011000001110000000000001
    11111001000000000000000000001
        1001000000000000000000001
111111111011000001110000000000001
100000000011000001110111111111111
11110111111111000000000011111
11110111111111011101010000001
11000000110101011100000010001
10000000000000001100000010001
10000000000000001101010010001
11000001110101011111011110001
11110111 1110101 101111000N01
11111111 1111111 111111111111